type octile
height 25
width 31
map
.....TTTTTTTTTTTTTTTTTTTTTT@@@@
.....T......T.TTTTTTTTTTTTT@@@@
.....T....TTT.TTTTTT....TTTT@@@
.....T.................TTTTTTT@
.....TTT...............TTTTTTT@
.....TTT................TTTTTT@
.....TTT.................T..TT@
....TTTT............TTT.....TTT
....TT..............TTT.....TTT
....TT..............TTT.....TTT
....TT.......TTTTTTT.......TTT@
.............TTTTTTT......TTTT@
.............TTTTTTTTT....TTTT@
....TT.......TTTTTTT.......TTT@
....TT.......TTTTTT........TTT@
....TTTT........TTT.TTT...TTTTT
.....TTT............TTT...TTTTT
.....TTT............TTT...TTTTT
.....TTT.................TTTTT@
.....TTT.......T.........TTTTT@
.....TTT......TT........TTTTTT@
.....T........TT........TTTTT@@
.....T.........TT.....TTTTT@@@@
.....TTT..TTTTTTTTTTTTTTTTT@@@@
@@@@@@@T..TT@@@@@@@@@@@@TT@@@@@
